####
# .#
#  ###
# @  #
#  $ #
#    #
######