#####
#   #
#@$##
#  ##
# .##
#####
