#########
####.####
#### ####
#       #
#  # #  #
#  $ $  #
#     # #
#   @ #.#
#########
